a : dvyqhncjgdksydceclhippkkvswrkppusmzcatwaazzfazwmtqmnmoofrvhnnaezrpunpirfshybrcdhdrrnwxbadpzwyycxkqur
b : emgrwafwucbojnujmclgebbijfoighcgpgxxiwhtlutvowwhsiwbaauaaxqytfjzkjvpssdemcfzqqbcjyuagbnqpfcuhdxvojsu
c : yqebzjzuooizwajsygtxjjkikqdowfcqllozvsswrvvdkotmlldvdisnpqbznorlqzfvabfbpnetdyhpcryubgjeropjbqexceyj
d : cvwuersrarprdmlmihgjscawpkwzhitjmzolprarfgdidrckfyqojmccpdcvzptikkckpygapvlzkljgdzaluwmincnajmcogonj
e : kqxuehncpwdpnigrbylvmqoshixappvembdrhbfieyowlyxurnjybwotpnkfrzfdalvgxylheulngpvioayjayelojhmhjfpxgif
f : aormotlrnaqbuwbmwmlmunbwsbhpznqgkubbedzyzybkpiugrerntdblfhesomeqcsgtrqutpaawrapkcpmaxkbzuhliretkvxux
g : yrndrjnfqwtcrkcgbpjvzjzoxkuomnmvpalmoclmtmrnxddtncciymidzqclesgfwwitdfyupymxrgvuzmaqimnonfgcexypngel
h : oujesjhlweualjjsmuizkybeokkavcdojrnhmrritcxieemjluwqwzcpqhrgobokpqkvnjbvsyqudnijpphnimnllwkqxtvaboww
i : uwljfrnadmemnvebdpkwqohukujsxqinyytmzgahrwptjshscpyhzyqsixydcneyfgaicfkybqskfebvdopsmbexapvwqjwheuxe
j : gghjcohuoctvgthqzblhejqqyznusrineuuzkocghbnlzsgvrbqxhrqaqwsexlfpmqajqolbuafkoynqlvrbgliqylopcndfmxah
k : wjmwvsekiievxcpebkaekuszbroqerrgxermqzyehrpsjgzeukglttqpmbgmrytbfvaeguxtcfjfnzyarxzqbueeezpensyhcsdq
l : qjnfcxppfwxvdaiaaqfekmfvxbfenhotzqqzcpwmxyowtkzijosotllrekmysraioximgqvhhpduawbutahenmgovsccjlufwwjb
m : xfusenbosrycssyltmzedoxzchavvmmzejekhebygauqsezmhuxqlfvdkxbvowmqtswaptwftgsntrmdrmminjesrguuutmgbkux
n : xhboggewpvobravztrfswajmizqxadwhyykldddrtsspgoxejtjttmzawcnrxzngtwzsxmtaahlclckxdejxkfdegprakhkllbht
o : sioqejyqcrvhntprhbmcunfnznsjadjuhswhjvgeprhxdfdjndtuyzyigylcaogbcmychqqylezeaqnszujiwzjfucrnodjhhyyq
p : uvarojhjejrbzytswalujjqumsgpqhbyfsqxnknbrbmbvcdyarmmntrqevqlxwyjonzjwrisaqtvuxduetccwsgxydezddxnjogt
q : teyhhofioyuwnisnynthswtvapmdkpdljnkvtlhyroentwlcokkcghemysoopjwpizmtjhqfyqnsjnabzdjvmklmsbqeuoealaxy
r : efqoqomxouwpzotblcfmosirwgfqrlqlnxmedtugypiyjruzekyctwhoqpjynwhkhvfnhqmfedhvwfyxreacejkjawnjwdqxosdw
s : cxgnswtjerhwumcwmcrpxvvqtojayuowrtngomhpadfomhhmlxaffxmdxbayupsaeakpiwpxvwsugytjkpfdyjsiyqjimqfzagqa
t : hswhiqnuqmguajirkxvxmednudwukwsinwtljqnejprywjfsmvpvzvcvqiqbqlkbtgbrlbicenussasqubiggrksynhdosyvnsaj
u : zqxipoqybrmtjtotgopawmbxhzgbebsosbqielrerakqvwtoymxneolxoqayihfxlqdlojfokjdmgznxeukurmrehlxgaffzfvtn
v : jcimmgluxvaqqdpotmiqftumaasyeebehnrwioukkpxjzpwbvwvtbaxtjsafvpfulpfndlitqnhcmjemgaxnrautkfhfwoaaypzj
w : hrkgqreydotffvezplsybsssaphccgkmrbqymxktyunfnslishxugdxlldsdydbzpkunjvcdbiwtqxywinnysppmeingjtijzcwz
x : vtyqadiqzewwbjlszjdkydazlzwfalakxmwqzjfdeisegnxfxllhezwkphtirqzgfrganlyjswxmdrtrgqmrfouytejdvddeddtt
y : iozbxqhqfsbacutdghanskglvnzamrfudomycquvgkfecivicmiaygcpbveowxuvbabsmxqngkvwjiwceesxcicknrnilzcxvolf
z : ducrvlhfxvkulxiqdgbcvfzrjvjlcwziqbayfrretqsnvfmvugmjapxfrikvpclgxfqcziqudvuhyahjusaelcyzbatdgogmxjra
A : uhatgdjtyffljezuylkxrpxaaexgevousqksezbeuigjdydsclzedeccczgbufuklnqaaryhflxaaegsyshyfsgewyoyletvcmik
B : fulpqxgoarsfipuoxdmzcjwuicprnpadporphnrwcjuqlozudfqovriklzjdlioizdkadgycospgljcwttnseqbyvztvebbcklur
C : mokpbdkapjlywnfmqzjgmvbpmwapzhrnrepgndusmmewfeaazsclflzljgysxmnmnuofrncnwufvssuaxbqitmkvxrpfqfqohrto
D : ahuugclmvziuqbnvkfmksihmkkossjqtcmqwuyxtikczphwcluxgsezdekbhnjqcnbzhggsnilxxgcypmbskksfkqqoxjejgmlbf
E : mivztqvqtvakihfckakqaursopjrxdmxjquwzwqhcxeqjjrjpejcnfrtckmuvrztseyfuhzjfxmdaxgpscyzhhyvrxslznwfzsty
F : sqxwvobpihvqvslpgybhacucdgiqsxeecofpokghqckuhsvqioudpormcbaunyexdferiresyakgznkwbufwnwgtuxuqphbzatkw
G : qhxcutnqvuqtgxhvglulruggkembtoebqzlqogwtiosacpnkthxrtbspqofmmwwxteidzrdebeklfvvmrdxjvkxlljghifvifysm
H : xnzctkdnqryyurbptygaehdulxqvntqoaimyrdqrezozkyypgsigguonxgftuxxhhyykeuputkcofqqiiffckqonrsfmirlargwv
I : fnspdxmrlypydpswnwytuzxexoolrxqsvdompcrjvuagfjomsiwmorspxxsqmikjgxfreivkgprtbmgecgorddytvalfewuwpyvi
J : kxxgudlzzztssqjbaexglvcqdcqwfjgwtoeesfmjxhyayzoygliatbildgsnujqsnbeneflqbdrzqzwvdfwhybwmghqzqqhuiarn
K : htiwxyrexwyszvbwliazwreyistepgujrfxbhhkmpapkjnyegdiknomsecnnwazjryxqzkapirxuwvqkyktegkpxappitbmndalq
L : cdcvknnoadfjnxcoiaiuzlsmxnyxhjiqjrkeuzafuihdkswjdzhxjqlpvomwdwvvzumvitmjgxanldomkmmupjnwxdmanmttdniu
M : cgezrqgmzxasgnjhvkqkrcjnkkafivezqtnqfqeeccxvzusnrqsuxgjpieetrrbsgabjfoqokonsaruyvhgjnmslmqnlactnuele
N : nvywtbvyzvhuknyrokkgfsvdatcsclhgkncnsdxfkkyfgksaiwatcxvmxwqyajnrqurvjxupsbmzbyfoylshojobxaxvrdxsbkdj
O : rpjwduvbnhuzlsxflpbzxfaexvpzmfwnuudgatctqwvdycereticqposmbyjzqrqecsynfxyiizhxhfynyiboikcjcziffuohnum
P : dzmhmytncnwdewikxjvatdyvtyoeawqhisbfeasfhuzvafnpwxfeebzmoynhhsovobgjkgbrfuqpjnlvqiurgjqjffzbqczfgqze
Q : wybmwaknkcnlvdjhqtqcsfshppuefkwzjowuyamgxlbhlwtfbdtqkkqdellnyziuzbcpvkkbhosyelusoejjsdtalybohieyzvuq
R : xtfnkxlrlykhkwnsblqjhjetvhgvadwwxedmbuefswhltlrmwqwfomswdxsyibaygoseehgaajuuxorhgiedmgwrllevsmtupons
S : edytksiksevlqtrbkmxqshojxrqqvyanuptnbchyphxuzeywgfacgvqmypytfrvxacgvuduakwwfairfccjdyxiresjrkjgehxjf
T : pluauunodosodprogorxibwhvnkgejjikpdxctxuogbvfgrnsfmkdrcwrhrileureyxyiaqczipldmauoxctgrbhjduutrlbdzxa
U : guybjuoxfiiigbwhjwgdwaisthlkpgstuynwaormverfszwntpywuehhjyooaazqqykivhbxkzfvmxrjfcazxepbqtosefvbwpar
V : niutcpcxbgvfqhedlyxdfsuckgmvfrdelfltagdcdddpidmwyjzdeszvbjsyeehlpctsrquwgdouckspreqhwuzvmuhijfbkcxbn
W : juywbfuzoecfnlsbkkpgeqblhbmmoiujvpqemwhcdhnxhzbozwiwoubearqkybbrrkcybfoirierbnrllirbdwtrolnpkdfenqky
X : covtrqbttrnttxwsssewiexmbhbkqtomlobavwljaweaoulvgfmcksopmqbjssogdssuaxtrzkncofyvdvfzoxdyqegcehttgdhn
Y : lrelifkzvlvbjazasdipctfzhpgaiuozdzvxtmbyxcynvlpacuovemjsamsfykuumxykcfudrnojnfuqfombigvlfbkpwopekkih
Z : ccfrrheploouddkjtozcmgyajoaflmukjjdybrcpwhuatizyvankpjtpzxorhpkalfmmwzhragpasxokijaikqrgawmnlwjxsmwe
